time 120 s
width 10
..........
..........
..........
..........
..........
..........
..........
..........
..........
..........
..PPPP....
..........
........P.
.S..P....m
GGGGGGGGGG