time 120 s
width 30
..............................
..............................
..............................
..............................
..............................
..............................
..............................
..............................
..............................
..............................
..PPPC..c.......c.............
.....................c........
..............................
.S.........e........e.......m.
GGGGGGGGGGGGGGGGGGGGGGGGGGGGGG