time 120 s
width 10
..........
..........
..........
..........
..........
..........
..........
..........
..........
..a..a....
..PPPP....
..........
........P.
.S...e...e
GGGGGGGGGG